7 7
3 5
#######
#  .  #
#     #
#  $  #
#     #
#     #
#######